scenes_stereo_testset/bus01.wav	bus
scenes_stereo_testset/bus02.wav	bus
scenes_stereo_testset/bus03.wav	restaurant
scenes_stereo_testset/bus04.wav	bus
scenes_stereo_testset/bus05.wav	openairmarket
scenes_stereo_testset/bus06.wav	bus
scenes_stereo_testset/bus07.wav	bus
scenes_stereo_testset/bus08.wav	bus
scenes_stereo_testset/bus09.wav	bus
scenes_stereo_testset/bus10.wav	bus
scenes_stereo_testset/busystreet01.wav	busystreet
scenes_stereo_testset/busystreet02.wav	busystreet
scenes_stereo_testset/busystreet03.wav	busystreet
scenes_stereo_testset/busystreet04.wav	busystreet
scenes_stereo_testset/busystreet05.wav	busystreet
scenes_stereo_testset/busystreet06.wav	busystreet
scenes_stereo_testset/busystreet07.wav	busystreet
scenes_stereo_testset/busystreet08.wav	busystreet
scenes_stereo_testset/busystreet09.wav	busystreet
scenes_stereo_testset/busystreet10.wav	busystreet
scenes_stereo_testset/office01.wav	office
scenes_stereo_testset/office02.wav	office
scenes_stereo_testset/office03.wav	office
scenes_stereo_testset/office04.wav	office
scenes_stereo_testset/office05.wav	restaurant
scenes_stereo_testset/office06.wav	office
scenes_stereo_testset/office07.wav	office
scenes_stereo_testset/office08.wav	office
scenes_stereo_testset/office09.wav	office
scenes_stereo_testset/office10.wav	office
scenes_stereo_testset/openairmarket01.wav	openairmarket
scenes_stereo_testset/openairmarket02.wav	openairmarket
scenes_stereo_testset/openairmarket03.wav	openairmarket
scenes_stereo_testset/openairmarket04.wav	openairmarket
scenes_stereo_testset/openairmarket05.wav	restaurant
scenes_stereo_testset/openairmarket06.wav	openairmarket
scenes_stereo_testset/openairmarket07.wav	openairmarket
scenes_stereo_testset/openairmarket08.wav	openairmarket
scenes_stereo_testset/openairmarket09.wav	openairmarket
scenes_stereo_testset/openairmarket10.wav	openairmarket
scenes_stereo_testset/park01.wav	park
scenes_stereo_testset/park02.wav	park
scenes_stereo_testset/park03.wav	openairmarket
scenes_stereo_testset/park04.wav	park
scenes_stereo_testset/park05.wav	quietstreet
scenes_stereo_testset/park06.wav	supermarket
scenes_stereo_testset/park07.wav	quietstreet
scenes_stereo_testset/park08.wav	office
scenes_stereo_testset/park09.wav	quietstreet
scenes_stereo_testset/park10.wav	quietstreet
scenes_stereo_testset/quietstreet01.wav	park
scenes_stereo_testset/quietstreet02.wav	openairmarket
scenes_stereo_testset/quietstreet03.wav	quietstreet
scenes_stereo_testset/quietstreet04.wav	busystreet
scenes_stereo_testset/quietstreet05.wav	park
scenes_stereo_testset/quietstreet06.wav	quietstreet
scenes_stereo_testset/quietstreet07.wav	quietstreet
scenes_stereo_testset/quietstreet08.wav	quietstreet
scenes_stereo_testset/quietstreet09.wav	quietstreet
scenes_stereo_testset/quietstreet10.wav	quietstreet
scenes_stereo_testset/restaurant01.wav	restaurant
scenes_stereo_testset/restaurant02.wav	restaurant
scenes_stereo_testset/restaurant03.wav	restaurant
scenes_stereo_testset/restaurant04.wav	restaurant
scenes_stereo_testset/restaurant05.wav	restaurant
scenes_stereo_testset/restaurant06.wav	restaurant
scenes_stereo_testset/restaurant07.wav	restaurant
scenes_stereo_testset/restaurant08.wav	restaurant
scenes_stereo_testset/restaurant09.wav	openairmarket
scenes_stereo_testset/restaurant10.wav	openairmarket
scenes_stereo_testset/supermarket01.wav	tubestation
scenes_stereo_testset/supermarket02.wav	supermarket
scenes_stereo_testset/supermarket03.wav	supermarket
scenes_stereo_testset/supermarket04.wav	restaurant
scenes_stereo_testset/supermarket05.wav	supermarket
scenes_stereo_testset/supermarket06.wav	supermarket
scenes_stereo_testset/supermarket07.wav	supermarket
scenes_stereo_testset/supermarket08.wav	supermarket
scenes_stereo_testset/supermarket09.wav	tubestation
scenes_stereo_testset/supermarket10.wav	tubestation
scenes_stereo_testset/tube01.wav	tube
scenes_stereo_testset/tube02.wav	restaurant
scenes_stereo_testset/tube03.wav	tubestation
scenes_stereo_testset/tube04.wav	tube
scenes_stereo_testset/tube05.wav	tube
scenes_stereo_testset/tube06.wav	supermarket
scenes_stereo_testset/tube07.wav	tubestation
scenes_stereo_testset/tube08.wav	openairmarket
scenes_stereo_testset/tube09.wav	tube
scenes_stereo_testset/tube10.wav	tube
scenes_stereo_testset/tubestation01.wav	tubestation
scenes_stereo_testset/tubestation02.wav	tubestation
scenes_stereo_testset/tubestation03.wav	tubestation
scenes_stereo_testset/tubestation04.wav	tubestation
scenes_stereo_testset/tubestation05.wav	restaurant
scenes_stereo_testset/tubestation06.wav	tubestation
scenes_stereo_testset/tubestation07.wav	supermarket
scenes_stereo_testset/tubestation08.wav	tubestation
scenes_stereo_testset/tubestation09.wav	tubestation
scenes_stereo_testset/tubestation10.wav	tube
